NO ./textures/test/NO.png
SO ./textures/test/SO.png
WE ./textures/test/WE.png
EA ./textures/test/EA.png

F 0,255,255
C 0,255,0

1111111111111111111111
1000000000000000000001
1000000011111111111001
10000W0011111111111001
1000000011111111111001
1000000000000000000001
1111111111111111111111